6 6 5 5 5 6 6 6 6 
6 6 5 7 5 6 6 6 6 
6 6 5 0 5 5 5 5 6 
5 5 5 4 0 4 7 5 6 
5 7 0 3 0 5 5 5 6 
5 5 5 5 4 5 6 6 6 
6 6 6 5 7 5 6 6 6 
6 6 6 5 5 5 6 6 6 
6 6 6 6 6 6 6 6 6 