6 6 6 6 6 6 6 6 6 6
6 5 5 5 5 5 5 5 5 6
6 5 0 0 0 0 0 0 5 6
6 5 0 0 0 0 0 0 5 6
6 5 0 4 0 4 0 0 5 6
6 5 0 0 3 0 0 0 5 6
6 5 0 0 0 0 0 0 5 6
6 5 0 0 0 0 0 0 5 6
6 5 0 0 0 0 0 0 5 6
6 5 5 5 5 5 5 5 5 6